9 6
######
#P..D#
#.##.#
#.##.#
#$..A#
#.##.#
#.##.#
#B*.R#
######
RLUU
2 1 1 7 4
DDRLUU
